11	16
32	32
0	1	2	3	1	1	1	1	4	1	5	6	2	3	0	0	
0	1	2	3	1	1	7	4	1	1	8	9	2	3	0	0	
0	1	2	3	1	1	4	1	1	1	10	11	2	3	0	0	
0	0	2	3	7	4	5	6	12	13	1	1	2	3	0	0	
0	0	0	0	0	0	0	0	0	0	1	1	2	3	0	0	
0	0	2	3	8	9	1	1	1	1	1	1	2	3	0	0	
0	0	2	3	10	11	1	1	1	1	14	0	0	0	0	0	
15	16	2	3	1	1	1	1	7	4	1	1	17	16	0	0	
18	19	2	3	1	1	1	1	4	1	1	1	5	6	0	0	
20	21	2	3	5	6	7	4	12	13	12	13	5	6	0	0	
0	0	0	0	0	0	0	0	0	0	0	0	0	0	0	0	
