10	48
32	32
0	0	1	2	1	2	1	2	1	2	1	2	0	0	0	0	0	0	1	2	1	2	1	2	1	2	1	2	0	0	0	0	0	0	0	0	0	0	0	0	3	4	5	6	5	6	7	8	
9	10	9	10	9	10	9	10	9	10	9	10	0	0	0	0	9	10	9	10	9	10	9	10	9	10	9	10	0	0	0	0	0	0	0	0	0	0	0	0	8	8	4	11	4	11	12	8	
13	14	13	14	13	14	13	14	13	14	13	14	1	2	1	2	13	14	13	14	13	14	13	14	13	14	13	14	1	2	1	2	1	2	1	2	1	2	1	2	8	15	16	11	16	11	17	8	
9	10	18	19	9	10	9	10	9	10	9	10	9	10	9	10	9	10	18	19	9	10	9	10	9	10	9	10	9	10	9	10	9	10	9	10	18	19	18	19	8	4	20	21	4	11	22	8	
13	14	23	24	13	14	13	14	13	14	13	14	13	14	13	14	13	14	23	24	13	14	13	14	13	14	13	14	13	14	13	14	13	14	13	14	23	24	23	24	8	25	26	8	16	11	7	8	
18	19	8	8	18	19	18	19	18	19	18	19	18	19	18	19	18	19	8	8	18	19	18	19	18	19	18	19	18	19	18	19	18	19	18	19	8	8	8	8	8	4	22	8	4	11	12	8	
23	24	27	28	23	24	23	24	23	24	23	24	23	24	23	24	23	24	27	28	23	24	23	24	23	24	23	24	23	24	23	24	23	24	23	24	27	28	8	8	8	25	7	8	16	11	17	8	
29	30	31	32	8	8	29	30	29	30	8	8	29	30	8	8	29	30	31	32	8	8	29	30	29	30	8	8	29	30	8	8	8	8	8	8	31	32	8	8	8	25	33	8	25	34	12	8	
35	36	37	38	39	39	35	36	35	36	39	39	35	36	39	39	35	36	37	38	39	39	35	36	35	36	39	39	35	36	39	39	39	39	40	41	37	38	42	43	44	45	46	8	46	47	17	8	
1601	1601	1601	1601	1601	1601	1601	1601	1601	1601	1601	1601	1601	1601	1601	1601	1601	1601	1601	1601	1601	1601	1601	1601	1601	1601	1601	1601	1601	1601	1601	1601	1601	1601	1601	1601	1601	1601	1601	1601	1601	1601	1601	1601	1601	1601	1601	1601	