11	0	1712	1712	1712
12	1712	1712	1712	1712
75	0	856	856	856
76	856	856	856	856
587	0	428	428	428
588	428	428	428	428
4683	0	214	214	214	642	643	644	645	646	647	648	749	750	751	752	753	754	755	856	857	858	859	860	861	862	963	964	965	966	967	968	969	1070	1071	1072	1073	1074	1075	1076
4684	214	214	214	214	648	649	650	651	652	653	654	655	755	756	757	758	759	760	761	762	862	863	864	865	866	867	868	869	969	970	971	972	973	974	975	976	1076	1077	1078	1079	1080	1081	1082	1083
4681	0	0	214	214	0	1	2	3	4	5	6	107	108	109	110	111	112	113	214	215	216	217	218	219	220	321	322	323	324	325	326	327	428	429	430	431	432	433	434	535	536	537	538	539	540	541	642	643	644	645	646	647	648
4682	214	0	214	214	6	7	8	9	10	11	12	13	113	114	115	116	117	118	119	120	220	221	222	223	224	225	226	227	327	328	329	330	331	332	333	334	434	435	436	437	438	439	440	441	541	542	543	544	545	546	547	548	648	649	650	651	652	653	654	655
585	0	0	428	428
4691	428	214	214	214	655	656	657	658	659	660	661	662	762	763	764	765	766	767	768	769	869	870	871	872	873	874	875	876	976	977	978	979	980	981	982	983	1083	1084	1085	1086	1087	1088	1089	1090
4692	642	214	214	214	662	663	664	665	666	667	668	769	770	771	772	773	774	775	876	877	878	879	880	881	882	983	984	985	986	987	988	989	1090	1091	1092	1093	1094	1095	1096
4689	428	0	214	214	13	14	15	16	17	18	19	20	120	121	122	123	124	125	126	127	227	228	229	230	231	232	233	234	334	335	336	337	338	339	340	341	441	442	443	444	445	446	447	448	548	549	550	551	552	553	554	555	655	656	657	658	659	660	661	662
4690	642	0	214	214	20	21	22	23	24	25	26	127	128	129	130	131	132	133	234	235	236	237	238	239	240	341	342	343	344	345	346	347	448	449	450	451	452	453	454	555	556	557	558	559	560	561	662	663	664	665	666	667	668
586	428	0	428	428
73	0	0	856	856
595	856	428	428	428
596	1284	428	428	428
4747	856	214	214	214	668	669	670	671	672	673	674	675	775	776	777	778	779	780	781	782	882	883	884	885	886	887	888	889	989	990	991	992	993	994	995	996	1096	1097	1098	1099	1100	1101	1102	1103
4748	1070	214	214	214	675	676	677	678	679	680	681	682	782	783	784	785	786	787	788	789	889	890	891	892	893	894	895	896	996	997	998	999	1000	1001	1002	1003	1103	1104	1105	1106	1107	1108	1109	1110
4745	856	0	214	214	26	27	28	29	30	31	32	33	133	134	135	136	137	138	139	140	240	241	242	243	244	245	246	247	347	348	349	350	351	352	353	354	454	455	456	457	458	459	460	461	561	562	563	564	565	566	567	568	668	669	670	671	672	673	674	675
4746	1070	0	214	214	33	34	35	36	37	38	39	40	140	141	142	143	144	145	146	147	247	248	249	250	251	252	253	254	354	355	356	357	358	359	360	361	461	462	463	464	465	466	467	468	568	569	570	571	572	573	574	575	675	676	677	678	679	680	681	682
593	856	0	428	428
4755	1284	214	214	214	682	683	684	685	686	687	688	789	790	791	792	793	794	795	896	897	898	899	900	901	902	1003	1004	1005	1006	1007	1008	1009	1110	1111	1112	1113	1114	1115	1116
4756	1498	214	214	214	688	689	690	691	692	693	694	695	795	796	797	798	799	800	801	802	902	903	904	905	906	907	908	909	1009	1010	1011	1012	1013	1014	1015	1016	1116	1117	1118	1119	1120	1121	1122	1123
4753	1284	0	214	214	40	41	42	43	44	45	46	147	148	149	150	151	152	153	254	255	256	257	258	259	260	361	362	363	364	365	366	367	468	469	470	471	472	473	474	575	576	577	578	579	580	581	682	683	684	685	686	687	688
4754	1498	0	214	214	46	47	48	49	50	51	52	53	153	154	155	156	157	158	159	160	260	261	262	263	264	265	266	267	367	368	369	370	371	372	373	374	474	475	476	477	478	479	480	481	581	582	583	584	585	586	587	588	688	689	690	691	692	693	694	695
594	1284	0	428	428
74	856	0	856	856
9	0	0	1712	1712
83	1712	856	856	856
84	2568	856	856	856
651	1712	428	428	428
652	2140	428	428	428
5195	1712	214	214	214	695	696	697	698	699	700	701	702	802	803	804	805	806	807	808	809	909	910	911	912	913	914	915	916	1016	1017	1018	1019	1020	1021	1022	1023	1123	1124	1125	1126	1127	1128	1129	1130
5196	1926	214	214	214	702	703	704	705	706	707	708	809	810	811	812	813	814	815	916	917	918	919	920	921	922	1023	1024	1025	1026	1027	1028	1029	1130	1131	1132	1133	1134	1135	1136
5193	1712	0	214	214	53	54	55	56	57	58	59	60	160	161	162	163	164	165	166	167	267	268	269	270	271	272	273	274	374	375	376	377	378	379	380	381	481	482	483	484	485	486	487	488	588	589	590	591	592	593	594	595	695	696	697	698	699	700	701	702
5194	1926	0	214	214	60	61	62	63	64	65	66	167	168	169	170	171	172	173	274	275	276	277	278	279	280	381	382	383	384	385	386	387	488	489	490	491	492	493	494	595	596	597	598	599	600	601	702	703	704	705	706	707	708
649	1712	0	428	428
5203	2140	214	214	214	708	709	710	711	712	713	714	715	815	816	817	818	819	820	821	822	922	923	924	925	926	927	928	929	1029	1030	1031	1032	1033	1034	1035	1036	1136	1137	1138	1139	1140	1141	1142	1143
5204	2354	214	214	214	715	716	717	718	719	720	721	722	822	823	824	825	826	827	828	829	929	930	931	932	933	934	935	936	1036	1037	1038	1039	1040	1041	1042	1043	1143	1144	1145	1146	1147	1148	1149	1150
5201	2140	0	214	214	66	67	68	69	70	71	72	73	173	174	175	176	177	178	179	180	280	281	282	283	284	285	286	287	387	388	389	390	391	392	393	394	494	495	496	497	498	499	500	501	601	602	603	604	605	606	607	608	708	709	710	711	712	713	714	715
5202	2354	0	214	214	73	74	75	76	77	78	79	80	180	181	182	183	184	185	186	187	287	288	289	290	291	292	293	294	394	395	396	397	398	399	400	401	501	502	503	504	505	506	507	508	608	609	610	611	612	613	614	615	715	716	717	718	719	720	721	722
650	2140	0	428	428
81	1712	0	856	856
659	2568	428	428	428
660	2996	428	428	428
5259	2568	214	214	214	722	723	724	725	726	727	728	829	830	831	832	833	834	835	936	937	938	939	940	941	942	1043	1044	1045	1046	1047	1048	1049	1150	1151	1152	1153	1154	1155	1156
5260	2782	214	214	214	728	729	730	731	732	733	734	735	835	836	837	838	839	840	841	842	942	943	944	945	946	947	948	949	1049	1050	1051	1052	1053	1054	1055	1056	1156	1157	1158	1159	1160	1161	1162	1163
5257	2568	0	214	214	80	81	82	83	84	85	86	187	188	189	190	191	192	193	294	295	296	297	298	299	300	401	402	403	404	405	406	407	508	509	510	511	512	513	514	615	616	617	618	619	620	621	722	723	724	725	726	727	728
5258	2782	0	214	214	86	87	88	89	90	91	92	93	193	194	195	196	197	198	199	200	300	301	302	303	304	305	306	307	407	408	409	410	411	412	413	414	514	515	516	517	518	519	520	521	621	622	623	624	625	626	627	628	728	729	730	731	732	733	734	735
657	2568	0	428	428
5267	2996	214	214	214	735	736	737	738	739	740	741	742	842	843	844	845	846	847	848	849	949	950	951	952	953	954	955	956	1056	1057	1058	1059	1060	1061	1062	1063	1163	1164	1165	1166	1167	1168	1169	1170
5268	3210	214	214	214	742	743	744	745	746	747	748	849	850	851	852	853	854	855	956	957	958	959	960	961	962	1063	1064	1065	1066	1067	1068	1069	1170	1171	1172	1173	1174	1175	1176
5265	2996	0	214	214	93	94	95	96	97	98	99	100	200	201	202	203	204	205	206	207	307	308	309	310	311	312	313	314	414	415	416	417	418	419	420	421	521	522	523	524	525	526	527	528	628	629	630	631	632	633	634	635	735	736	737	738	739	740	741	742
5266	3210	0	214	214	100	101	102	103	104	105	106	207	208	209	210	211	212	213	314	315	316	317	318	319	320	421	422	423	424	425	426	427	528	529	530	531	532	533	534	635	636	637	638	639	640	641	742	743	744	745	746	747	748
658	2996	0	428	428
82	2568	0	856	856
10	1712	0	1712	1712
1	0	0	3424	3424
