11	0	816	816	816
12	816	816	816	816
75	0	408	408	408
76	408	408	408	408
587	0	204	204	204	306	307	308	309	310	311	312	357	358	359	360	361	362	363	408	409	410	411	412	413	414	459	460	461	462	463	464	465	510	511	512	513	514	515	516
588	204	204	204	204	312	313	314	315	316	317	318	363	364	365	366	367	368	369	414	415	416	417	418	419	420	465	466	467	468	469	470	471	516	517	518	519	520	521	522
585	0	0	204	204	0	1	2	3	4	5	6	51	52	53	54	55	56	57	102	103	104	105	106	107	108	153	154	155	156	157	158	159	204	205	206	207	208	209	210	255	256	257	258	259	260	261	306	307	308	309	310	311	312
586	204	0	204	204	6	7	8	9	10	11	12	57	58	59	60	61	62	63	108	109	110	111	112	113	114	159	160	161	162	163	164	165	210	211	212	213	214	215	216	261	262	263	264	265	266	267	312	313	314	315	316	317	318
73	0	0	408	408
595	408	204	204	204	318	319	320	321	322	323	324	325	369	370	371	372	373	374	375	376	420	421	422	423	424	425	426	427	471	472	473	474	475	476	477	478	522	523	524	525	526	527	528	529
596	612	204	204	204	325	326	327	328	329	330	331	376	377	378	379	380	381	382	427	428	429	430	431	432	433	478	479	480	481	482	483	484	529	530	531	532	533	534	535
593	408	0	204	204	12	13	14	15	16	17	18	19	63	64	65	66	67	68	69	70	114	115	116	117	118	119	120	121	165	166	167	168	169	170	171	172	216	217	218	219	220	221	222	223	267	268	269	270	271	272	273	274	318	319	320	321	322	323	324	325
594	612	0	204	204	19	20	21	22	23	24	25	70	71	72	73	74	75	76	121	122	123	124	125	126	127	172	173	174	175	176	177	178	223	224	225	226	227	228	229	274	275	276	277	278	279	280	325	326	327	328	329	330	331
74	408	0	408	408
9	0	0	816	816
83	816	408	408	408
84	1224	408	408	408
651	816	204	204	204	331	332	333	334	335	336	337	382	383	384	385	386	387	388	433	434	435	436	437	438	439	484	485	486	487	488	489	490	535	536	537	538	539	540	541
652	1020	204	204	204	337	338	339	340	341	342	343	344	388	389	390	391	392	393	394	395	439	440	441	442	443	444	445	446	490	491	492	493	494	495	496	497	541	542	543	544	545	546	547	548
649	816	0	204	204	25	26	27	28	29	30	31	76	77	78	79	80	81	82	127	128	129	130	131	132	133	178	179	180	181	182	183	184	229	230	231	232	233	234	235	280	281	282	283	284	285	286	331	332	333	334	335	336	337
650	1020	0	204	204	31	32	33	34	35	36	37	38	82	83	84	85	86	87	88	89	133	134	135	136	137	138	139	140	184	185	186	187	188	189	190	191	235	236	237	238	239	240	241	242	286	287	288	289	290	291	292	293	337	338	339	340	341	342	343	344
81	816	0	408	408
659	1224	204	204	204	344	345	346	347	348	349	350	395	396	397	398	399	400	401	446	447	448	449	450	451	452	497	498	499	500	501	502	503	548	549	550	551	552	553	554
660	1428	204	204	204	350	351	352	353	354	355	356	401	402	403	404	405	406	407	452	453	454	455	456	457	458	503	504	505	506	507	508	509	554	555	556	557	558	559	560
657	1224	0	204	204	38	39	40	41	42	43	44	89	90	91	92	93	94	95	140	141	142	143	144	145	146	191	192	193	194	195	196	197	242	243	244	245	246	247	248	293	294	295	296	297	298	299	344	345	346	347	348	349	350
658	1428	0	204	204	44	45	46	47	48	49	50	95	96	97	98	99	100	101	146	147	148	149	150	151	152	197	198	199	200	201	202	203	248	249	250	251	252	253	254	299	300	301	302	303	304	305	350	351	352	353	354	355	356
82	1224	0	408	408
10	816	0	816	816
1	0	0	1632	1632
